469, 470, 469, 470, 469, 470, 469, 470, 469, 470, 469, 470, 469, 470, 469, 470, 469, 470, 469, 470, 469, 470, 469, 470, 469, 470, 469, 470, 469, 470, 469, 470, 469, 470, 469, 470,
            477, 478, 477, 478, 477, 478, 477, 478, 477, 478, 477, 478, 477, 478, 477, 478, 477, 478, 477, 478, 477, 478, 477, 478, 477, 478, 477, 478, 477, 478, 477, 478, 477, 478, 477, 478,
            469, 470, 469, 470, 469, 470, 469, 470, 469, 470, 469, 470, 469, 470, 469, 470, 469, 470, 469, 470, 469, 470, 469, 470, 469, 470, 469, 470, 469, 470, 469, 470, 469, 470, 469, 470,
            477, 478, 477, 478, 477, 478, 477, 478, 477, 478, 477, 478, 477, 478, 477, 478, 477, 478, 477, 478, 477, 478, 477, 478, 477, 478, 477, 478, 477, 478, 477, 478, 477, 478, 477, 478,
            469, 470, 469, 470, 469, 470, 469, 470, 469, 470, 469, 470, 469, 470, 469, 470, 469, 470, 469, 470, 469, 470, 469, 470, 469, 470, 469, 470, 469, 470, 469, 470, 469, 470, 469, 470,
            477, 478, 477, 478, 477, 478, 477, 478, 477, 478, 477, 478, 477, 478, 477, 478, 487, 488, 487, 488, 477, 478, 477, 478, 477, 478, 477, 478, 477, 478, 477, 478, 477, 478, 477, 478,
            469, 470, 469, 470, 469, 470, 469, 470, 471, 472, 471, 472, 471, 472, 471, 472, 2, 465, 467, 2, 471, 472, 471, 472, 471, 472, 471, 472, 469, 470, 469, 470, 469, 470, 469, 470,
            477, 478, 477, 478, 477, 478, 477, 478, 477, 480, 477, 480, 487, 488, 487, 488, 465, 474, 475, 2, 487, 488, 487, 488, 477, 478, 477, 478, 477, 478, 477, 478, 477, 478, 477, 478,
            469, 470, 469, 470, 469, 470, 469, 470, 471, 472, 471, 472, 2, 2, 2, 2, 474, 474, 474, 467, 2, 2, 2, 2, 471, 472, 471, 472, 469, 470, 469, 470, 469, 470, 469, 470,
            477, 478, 477, 478, 477, 478, 477, 478, 477, 478, 487, 488, 2, 2, 2, 2, 474, 474, 474, 475, 2, 41, 42, 42, 646, 488, 477, 478, 477, 478, 477, 478, 477, 478, 477, 478,
            469, 470, 469, 470, 469, 470, 469, 470, 471, 472, 2, 2, 621, 622, 622, 623, 474, 474, 474, 475, 2, 49, 50, 51, 52, 2, 471, 472, 469, 470, 469, 470, 469, 470, 469, 470,
            477, 478, 477, 478, 477, 478, 477, 478, 477, 478, 2, 5, 629, 630, 630, 631, 474, 474, 474, 474, 467, 57, 58, 59, 60, 2, 477, 478, 477, 478, 477, 478, 477, 478, 477, 478,
            469, 470, 469, 470, 469, 470, 469, 470, 471, 472, 5, 2, 637, 640, 638, 639, 474, 474, 474, 474, 475, 97, 66, 67, 68, 2, 471, 472, 469, 470, 469, 470, 469, 470, 469, 470,
            477, 478, 477, 478, 477, 478, 477, 478, 477, 478, 2, 5, 645, 648, 656, 647, 474, 482, 482, 482, 474, 466, 466, 466, 466, 467, 487, 488, 477, 478, 477, 478, 477, 478, 477, 478,
            469, 470, 469, 470, 469, 470, 469, 470, 471, 472, 5, 2, 2, 465, 466, 466, 475, 2, 2, 5, 473, 474, 474, 474, 474, 474, 467, 2, 469, 470, 469, 470, 469, 470, 469, 470,
            477, 478, 477, 478, 477, 478, 477, 478, 487, 488, 2, 465, 466, 474, 474, 474, 475, 5, 2, 4, 473, 474, 474, 474, 474, 474, 483, 2, 477, 478, 477, 478, 477, 478, 477, 478,
            469, 470, 469, 470, 469, 470, 469, 470, 519, 2, 465, 474, 474, 474, 474, 474, 475, 2, 5, 2, 473, 474, 474, 474, 474, 483, 2, 2, 469, 470, 469, 470, 469, 470, 469, 470,
            477, 478, 477, 478, 477, 478, 477, 478, 520, 464, 481, 482, 482, 474, 474, 474, 474, 466, 466, 466, 474, 474, 474, 482, 483, 2, 463, 464, 477, 478, 477, 478, 477, 478, 477, 478,
            469, 470, 469, 470, 469, 470, 469, 470, 471, 472, 2, 2, 2, 481, 482, 474, 474, 474, 474, 474, 474, 474, 475, 2, 2, 2, 471, 472, 469, 470, 469, 470, 469, 470, 469, 470,
            477, 478, 477, 478, 477, 478, 477, 478, 477, 478, 2, 2, 2, 73, 74, 643, 644, 474, 474, 474, 474, 482, 621, 622, 622, 623, 477, 480, 477, 478, 477, 478, 477, 478, 477, 478,
            469, 470, 469, 470, 469, 470, 469, 470, 471, 472, 2, 2, 2, 81, 82, 83, 84, 474, 474, 474, 475, 2, 629, 630, 630, 631, 471, 472, 469, 470, 469, 470, 469, 470, 469, 470,
            477, 478, 477, 478, 477, 478, 477, 478, 477, 478, 463, 464, 2, 89, 90, 91, 92, 474, 474, 474, 475, 2, 637, 640, 638, 639, 477, 478, 477, 478, 477, 478, 477, 478, 477, 478,
            469, 470, 469, 470, 469, 470, 469, 470, 471, 472, 471, 472, 2, 97, 98, 99, 100, 474, 474, 474, 483, 2, 645, 648, 656, 647, 471, 472, 469, 470, 469, 470, 469, 470, 469, 470,
            477, 478, 477, 478, 477, 478, 477, 478, 477, 478, 477, 478, 2, 2, 2, 465, 474, 474, 474, 475, 2, 2, 2, 2, 463, 464, 477, 480, 477, 478, 477, 478, 477, 478, 477, 478,
            469, 470, 469, 470, 469, 470, 469, 470, 471, 472, 471, 472, 2, 2, 2, 473, 474, 474, 474, 475, 2, 2, 2, 2, 471, 472, 471, 472, 469, 470, 469, 470, 469, 470, 469, 470,
            477, 478, 477, 478, 477, 478, 477, 478, 477, 478, 477, 478, 463, 464, 463, 481, 474, 474, 474, 483, 463, 464, 463, 464, 477, 478, 477, 478, 477, 478, 477, 478, 477, 478, 477, 478,
            469, 470, 469, 470, 469, 470, 469, 470, 469, 472, 469, 472, 469, 472, 469, 472, 473, 474, 474, 2, 471, 472, 469, 472, 469, 472, 469, 472, 469, 470, 469, 470, 469, 470, 469, 470,
            477, 478, 477, 478, 477, 478, 477, 478, 477, 480, 487, 488, 487, 488, 487, 488, 481, 482, 483, 2, 487, 488, 487, 488, 479, 480, 477, 480, 477, 478, 477, 478, 477, 478, 477, 478,
            469, 470, 469, 470, 469, 470, 469, 470, 469, 472, 14, 14, 14, 2, 2, 2, 2, 2, 2, 2, 2, 14, 14, 14, 469, 472, 469, 472, 469, 470, 469, 470, 469, 470, 469, 470,
            477, 478, 477, 478, 477, 478, 477, 478, 487, 488, 14, 14, 14, 14, 2, 2, 2, 2, 2, 2, 14, 14, 14, 14, 487, 488, 477, 480, 477, 478, 477, 478, 477, 478, 477, 478,
            469, 470, 469, 470, 469, 470, 469, 470, 14, 14, 14, 14, 14, 14, 2, 2, 2, 2, 2, 2, 14, 14, 14, 14, 14, 14, 469, 472, 469, 470, 469, 470, 469, 470, 469, 470,
            477, 478, 477, 478, 477, 478, 477, 478, 455, 456, 14, 14, 14, 2, 2, 2, 2, 2, 2, 463, 456, 14, 14, 14, 14, 14, 487, 488, 477, 478, 477, 478, 477, 478, 477, 478,
            469, 470, 469, 470, 469, 470, 469, 470, 469, 472, 14, 14, 2, 2, 111, 136, 136, 136, 136, 471, 472, 455, 456, 14, 14, 2, 2, 2, 469, 470, 469, 470, 469, 470, 469, 470,
            477, 478, 477, 478, 477, 478, 477, 478, 477, 478, 214, 136, 136, 136, 143, 2, 2, 2, 2, 479, 480, 471, 472, 2, 2, 465, 467, 2, 477, 478, 477, 478, 477, 478, 477, 478,
            469, 470, 469, 470, 469, 470, 469, 470, 469, 472, 463, 464, 2, 2, 2, 2, 2, 2, 2, 471, 472, 487, 488, 2, 465, 474, 475, 2, 469, 470, 469, 470, 469, 470, 469, 470,
            477, 478, 477, 478, 477, 478, 477, 478, 479, 480, 471, 472, 2, 4, 2, 465, 466, 467, 2, 487, 488, 14, 14, 2, 481, 474, 474, 467, 477, 478, 477, 478, 477, 478, 477, 478,
            469, 470, 469, 470, 469, 470, 469, 470, 469, 472, 479, 480, 2, 465, 466, 474, 474, 475, 2, 14, 14, 14, 14, 14, 2, 481, 474, 475, 469, 470, 469, 470, 469, 470, 469, 470,
            477, 478, 477, 478, 477, 478, 477, 478, 479, 480, 471, 472, 2, 481, 474, 474, 474, 483, 2, 14, 14, 14, 14, 14, 14, 2, 481, 483, 477, 478, 477, 478, 477, 478, 477, 478,
            469, 470, 469, 470, 469, 470, 469, 470, 471, 472, 487, 488, 2, 2, 481, 482, 483, 2, 2, 14, 14, 14, 14, 14, 14, 2, 2, 2, 469, 470, 469, 470, 469, 470, 469, 470,
            477, 478, 477, 478, 477, 478, 477, 478, 487, 488, 14, 14, 2, 2, 2, 2, 214, 136, 136, 215, 455, 456, 14, 14, 14, 2, 463, 464, 477, 478, 477, 478, 477, 478, 477, 478,
            469, 470, 469, 470, 469, 470, 469, 470, 14, 14, 14, 14, 14, 2, 2, 2, 2, 2, 2, 2, 471, 472, 14, 14, 2, 2, 471, 472, 469, 470, 469, 470, 469, 470, 469, 470,
            477, 478, 477, 478, 477, 478, 477, 478, 455, 456, 14, 14, 14, 14, 2, 2, 2, 2, 2, 2, 479, 480, 455, 456, 463, 464, 477, 480, 477, 478, 477, 478, 477, 478, 477, 478,
            469, 470, 469, 470, 469, 470, 469, 470, 469, 472, 14, 14, 14, 14, 2, 2, 2, 2, 2, 2, 469, 470, 469, 470, 469, 470, 469, 470, 469, 470, 469, 470, 469, 470, 469, 470,
            477, 478, 477, 478, 477, 478, 477, 478, 479, 480, 455, 456, 455, 464, 463, 464, 463, 464, 2, 2, 479, 480, 479, 480, 479, 480, 479, 480, 477, 478, 477, 478, 477, 478, 477, 478,
            469, 470, 469, 470, 469, 470, 469, 470, 469, 470, 469, 470, 469, 470, 469, 470, 469, 470, 2, 2, 469, 470, 469, 470, 469, 470, 469, 470, 469, 470, 469, 470, 469, 470, 469, 470,
            477, 478, 477, 478, 477, 478, 477, 478, 477, 478, 477, 478, 477, 478, 477, 478, 477, 478, 2, 2, 477, 478, 477, 478, 477, 478, 477, 478, 477, 478, 477, 478, 477, 478, 477, 478,
            469, 470, 469, 470, 469, 470, 469, 470, 469, 470, 469, 470, 469, 470, 469, 470, 469, 470, 2, 2, 469, 470, 469, 470, 469, 470, 469, 470, 469, 470, 469, 470, 469, 470, 469, 470,
            477, 478, 477, 478, 477, 478, 477, 478, 477, 478, 485, 486, 485, 486, 485, 486, 485, 486, 2, 2, 487, 486, 487, 486, 487, 486, 487, 478, 477, 478, 477, 478, 477, 478, 477, 478,
            469, 470, 469, 470, 469, 470, 469, 470, 471, 472, 2, 2, 2, 2, 2, 2, 2, 2, 2, 2, 2, 2, 2, 2, 2, 2, 469, 470, 469, 470, 469, 470, 469, 470, 469, 470,
            477, 478, 477, 478, 477, 478, 477, 478, 485, 488, 2, 2, 2, 2, 2, 2, 2, 2, 2, 2, 2, 2, 2, 2, 2, 2, 487, 486, 477, 478, 477, 478, 477, 478, 477, 478,
            469, 470, 469, 470, 469, 470, 469, 470, 2, 2, 521, 522, 522, 522, 523, 2, 2, 2, 2, 2, 2, 521, 522, 522, 522, 523, 2, 2, 469, 470, 469, 470, 469, 470, 469, 470,
            477, 478, 477, 478, 477, 478, 477, 478, 2, 2, 529, 530, 530, 530, 531, 2, 2, 2, 2, 2, 2, 529, 530, 530, 530, 531, 2, 2, 477, 478, 477, 478, 477, 478, 477, 478,
            469, 470, 469, 470, 469, 470, 469, 470, 2, 2, 537, 538, 538, 538, 539, 2, 2, 2, 2, 2, 2, 537, 538, 538, 538, 539, 2, 2, 469, 470, 469, 470, 469, 470, 469, 470,
            477, 478, 477, 478, 477, 478, 477, 478, 2, 2, 547, 563, 561, 577, 546, 2, 2, 2, 2, 2, 2, 545, 577, 562, 563, 548, 2, 5, 477, 478, 477, 478, 477, 478, 477, 478,
            469, 470, 469, 470, 469, 470, 469, 470, 5, 2, 555, 571, 569, 585, 554, 4, 2, 2, 2, 2, 4, 553, 585, 570, 571, 556, 5, 2, 469, 470, 469, 470, 469, 470, 469, 470,
            477, 478, 477, 478, 477, 478, 477, 478, 2, 5, 2, 2, 2, 514, 2, 2, 2, 2, 2, 2, 2, 2, 514, 2, 2, 2, 2, 5, 477, 478, 477, 478, 477, 478, 477, 478,
            469, 470, 469, 470, 469, 470, 469, 470, 5, 2, 2, 5, 2, 2, 2, 2, 2, 2, 2, 2, 2, 2, 2, 2, 5, 2, 5, 2, 469, 470, 469, 470, 469, 470, 469, 470,
            477, 478, 477, 478, 477, 478, 477, 478, 2, 2, 2, 2, 2, 2, 2, 2, 2, 2, 2, 2, 2, 2, 2, 2, 2, 2, 2, 2, 477, 478, 477, 478, 477, 478, 477, 478,
            469, 470, 469, 470, 469, 470, 469, 470, 2, 2, 2, 525, 579, 580, 526, 526, 526, 527, 2, 2, 2, 2, 2, 2, 2, 2, 2, 2, 469, 470, 469, 470, 469, 470, 469, 470,
            477, 478, 477, 478, 477, 478, 477, 478, 2, 2, 2, 533, 587, 588, 534, 534, 534, 535, 2, 2, 2, 2, 2, 4, 2, 2, 2, 2, 477, 478, 477, 478, 477, 478, 477, 478,
            469, 470, 469, 470, 469, 470, 469, 470, 2, 2, 2, 533, 534, 534, 534, 534, 534, 535, 2, 2, 2, 2, 2, 2, 2, 2, 2, 2, 469, 470, 469, 470, 469, 470, 469, 470,
            477, 478, 477, 478, 477, 478, 477, 478, 2, 2, 2, 541, 528, 528, 557, 578, 558, 544, 2, 2, 2, 2, 2, 2, 2, 2, 463, 464, 477, 478, 477, 478, 477, 478, 477, 478,
            469, 470, 469, 470, 469, 470, 469, 470, 2, 2, 2, 551, 536, 536, 565, 586, 566, 552, 2, 2, 2, 2, 2, 2, 2, 2, 471, 472, 469, 470, 469, 470, 469, 470, 469, 470,
            477, 478, 477, 478, 477, 478, 477, 478, 463, 464, 2, 5, 5, 5, 4, 514, 2, 2, 2, 2, 2, 2, 2, 2, 463, 464, 477, 478, 477, 478, 477, 478, 477, 478, 477, 478,
            469, 470, 469, 470, 469, 470, 469, 470, 471, 472, 2, 5, 5, 5, 2, 2, 2, 2, 2, 2, 2, 2, 2, 2, 469, 470, 469, 470, 469, 470, 469, 470, 469, 470, 469, 470,
            477, 478, 477, 478, 477, 478, 477, 478, 477, 478, 463, 464, 463, 464, 463, 464, 463, 464, 463, 464, 463, 464, 463, 464, 477, 478, 477, 478, 477, 478, 477, 478, 477, 478, 477, 478,
            469, 470, 469, 470, 469, 470, 469, 470, 469, 470, 469, 470, 469, 470, 469, 470, 469, 470, 469, 470, 469, 470, 469, 470, 469, 470, 469, 470, 469, 470, 469, 470, 469, 470, 469, 470,
            477, 478, 477, 478, 477, 478, 477, 478, 477, 478, 477, 478, 477, 478, 477, 478, 477, 478, 477, 478, 477, 478, 477, 478, 477, 478, 477, 478, 477, 478, 477, 478, 477, 478, 477, 478,
            469, 470, 469, 470, 469, 470, 469, 470, 469, 470, 469, 470, 469, 470, 469, 470, 469, 470, 469, 470, 469, 470, 469, 470, 469, 470, 469, 470, 469, 470, 469, 470, 469, 470, 469, 470,
            477, 478, 477, 478, 477, 478, 477, 478, 477, 478, 477, 478, 477, 478, 477, 478, 477, 478, 477, 478, 477, 478, 477, 478, 477, 478, 477, 478, 477, 478, 477, 478, 477, 478, 477, 478,
            469, 470, 469, 470, 469, 470, 469, 470, 469, 470, 469, 470, 469, 470, 469, 470, 469, 470, 469, 470, 469, 470, 469, 470, 469, 470, 469, 470, 469, 470, 469, 470, 469, 470, 469, 470,
            477, 478, 477, 478, 477, 478, 477, 478, 477, 478, 477, 478, 477, 478, 477, 478, 477, 478, 477, 478, 477, 478, 477, 478, 477, 478, 477, 478, 477, 478, 477, 478, 477, 478, 477, 478,